***********************************************************
*             **       **       **       **       **      *
* ******                                                  *
*           ******   ******   ******   ******   ******    *
*****                                                     *
*             *        *        *        *        *       *
* ******    *****    *****    *****    *****    *****     *
*             *        *        *        *        *       *
*****                                                     *
*          *   *  *   *  *   *  *   *  *   *    *   *     *
* *****      *      *      *      *      *    *   *   *   *
*          *   *  *   *  *   *  *   *  *   *   *     *    *
*****                                            ****     *
*             *       *       *       *       *       *   *
* *****       *       *       *       *       *       *   *
*         *   *   *   *   *   *   *   *   *   *   *   *   *
*****     *   *   *   *   *   *   *   *   *   *   *   *   *
*     *   *   *   *   *   *   *   *   *   *   *   *   *   *
*     *   *       *       *       *       *       *       *
***********************************************************
